R 640 480
NO ./images/NO.xpm
SO ./images/SO.xpm
WE ./images/WE.xpm
EA ./images/EA.xpm
S ./images/ITEM.xpm
F 110,153,15
C 255,255,255

111111111111
100000000001
100000001001
1000E0000011
100000000001
100000000001
111111111111
