R 640 480
NO ./images/NO.xpm
SO ./images/SO.xpm
WE ./images/WE.xpm
EA ./images/EA.xpm
S ./images/ITEM.xpm
F 110,153,15
C 255,255,255

1111111111
1000000001
1000000001
1000000001
11000W0001
1000000001
1000000001
1000000001
1111111111
