C 0 , 191 , 255
R   643   481
NO ./images/NO.xpm

EA  ./images/EA.xpm
SO    ./images/SO.xpm
WE ./images/WE.xpm
S  ./images/ITEM.xpm
F 40, 31  ,   19000 4

111111111111111111111
100000000000000000001
100000000000000000001
100000000000000000001
100000000000000000001
100000000000000000001
100000000000000000001
100000000000000000001
100000000000000000001
100000000000000000001
100000000000000000001
100000000000000000001
100000000000000000001
100000000000000000001
100000000000000000001
100020000000000000001
100202000000000000001
100020000000000000001
100000001000000000001
100000000021000000001
100000000000000000001
100000000000000000001
1000000000N0000000001
100000000000000000001
100000000000000000001
100000000000000000001
100000000000000000001
100000000000000000001
100000000000000000001
100000000000000000001
100000000000000000001
100000000000100000001
100000000000000000001
100000000000100000001
100000000000000000001
100000200000000000001
100000000000000000001
100000000000000000001
100000000000000000001
100000000000000000001
100000000000000000001
100000000111110111101
100000000111110111101
110000001111110111101
101000000111100111101
100000000111100111101
100000000111110111101
1000000001111101111011111
1000000001111101111000001
100000000111110111111110111
100000000000000000000000001
100000000111111110111111101
100000000000000000000000001
10010000011111111111111111
1000000001111111111
1111111111111111111
1111111111111111111
