R 640 480
NO ./images/NO.xpm
SO ./images/SO.xpm
WE ./images/WE.xpm
EA ./images/EA.xpm
S ./images/ITEM.xpm
F 110,153,15
C 255,255,255

1111111111
1000000001
1000100001
1000010001
1100000011
1010000001
1000000001
10000E0001
1000001001
1000000001
1000000001
1000000001
1000000001
1000000001
1000000001
1000000001
1111111111
