R 640 480
NO ./images/NO.xpm
SO ./images/SO.xpm
WE ./images/WE.xpm
EA ./images/EA.xpm
S ./images/ITEM.xpm
F 40,31,19000
C 0,191,255

                   101
0111111111111111
100000000000000111111
100000000000000000001
100000000000000000001
100000000000000000001
100000000000000000000
100000000000000000001
100000000000000000001
11111111111111111111
1111111111111111111
           11
           0

//увеличить строки до одинаковой длины
// добавить строчки со всех сторон из пробелов
// check_around вокруг нулей
..........................
.                        .
.                    101 .
. 0111111111111111       .
. 100000000000000111111  .
. 100000000000000000001  .
. 100000000000000000001  .
. 100000000000000000001  .
. 100000000000000000000  .
. 100000000000000000001  .
. 100000000000000000001  .
. 11111111111111111111   .
. 1111111111111111111    .
.            11          .
.            0           .
.                        .
..........................
