R 640 480
NO ./images/NO.xpm
SO ./images/SO.xpm
WE ./images/WE.xpm
EA ./images/EA.xpm
S ./images/ITEM.xpm
F 110,153,15
C 255,255,255

1111111
1110001
1000001
1100001
11N0111
1000001
1111111
