R 640 480
NO ./images/NO.xpm
SO ./images/SO.xpm
WE ./images/WE.xpm
EA ./images/EA.xpm
S ./images/ITEM.xpm
F 110,153,15
C 255,255,255

11111111111111111
11000000000000001
10000000000000001
1000000E000000001
10000000000000001
10000000000000001
11111111111111111
