C 0 , 191 , 255
NO ./images/NO.xpm
SO    ./images/SO.xpm
WE ./images/WE.xpm
S  ./images/ITEM.xpm
EA ./images/EA.xpm
R 100 -100
F 40, 31  ,   19000


11111111111
10222210001             111
120000000211111111111111121
120000000000000000000000001
10000N000011111111111111111
10022220001
11111111111
