C 0 , 191 , 255
NO ./images/NO.xpm
SO    ./images/SO.xpm
WE ./images/WE.xpm
S  ./images/ITEM.xpm
EA ./images/EA.xpm
R   2000   2000
F 40, 31  ,   19000


 11111111111
10222210001
10000N00001
10000000001
11111111111
