R 640 480
NO ./images/NO.xpm
SO ./images/SO.xpm
WE ./images/WE.xpm
EA ./images/EA.xpm
S ./images/ITEM.xpm
F 110,153,15
C 255,255,255

1111111111111111111111111
1000000000000000000000001
1000000010100000000000001
10000000101010000000000011
11111111101010000000000001
10000000001000000000000001111
10000000001000000000000000001
10000000001000011111110000001
10000000001000000000010000001
10000N00001011111111010000001
10000000001010000001010000001
10000000001010000001011110111
1000000000100000000100000001
1111111111111111111111111111
