C 0 , 191 , 255
NO ./images/NO.xpm
SO    ./images/SO.xpm
WE ./images/WE.xpm
S  ./images/ITEM.xpm
EA ./images/EA.xpm
R   00000000001000   000000000000000001000
F 40, 31  ,   19000


11111111111
10222210001
12000000021
12000000021
10000N00001
10022220001
11111111111
