R 1920 1080
NO ./images/NO.xpm
SO ./images/SO.xpm
WE ./images/WE.xpm
EA ./images/EA.xpm
S ./images/ITEM.xpm
F 110,153,15
C 255,255,255

1111111111
1000000001
1000000001
1000000001
11000N0011
1000000001
1000000001
1000000001
1111111111
