1111111111111
1           1
1 N         1
1           1
1           1
1           1
1           1
1111111111111
