R 640 480
NO ./images/NO.xpm
SO ./images/SO.xpm
WE ./images/WE.xpm
EA ./images/EA.xpm
S ./images/ITEM.xpm
F 40,31,19000
C 0,191,255

111111111111111111111
100000000000000111111
100000000000000000001
100000000000000000001
100000000000000000001
10000000000N000000001
100000000000000000001
100000000000000000001
111111111111111111111
