C 0 , 191 , 255
R   7000   10000
NO ./images/NO.xpm

EA  ./images/EA.xpm
SO    ./images/SO.xpm
WE ./images/WE.xpm
S  ./images/ITEM.xpm
F 40, 31  ,   19000 4

111111111111111111111
100000000000000000001
100000000000000000001
100000000000000000001
100000000000000000001
100000000000000000001
100000000000000000001
100000000000000000001
100000000000000000001
100022222222222200001
100000000000000000001
100000000000000000001
100000000000000000001
100000000000000000001
100000000000000000001
100000000000000200001
10000200W000000000001
100000000000000000001
100000000000000000001
100000000000000000001
100000000000000000001
100000000000000000001
100000000000000000001
100000000000000000001
100000000000000000001
100000000000000000001
100000000000000000001
100000000000000000001
100000000000000000001
100000000000000000001
100000000000000000001
100000000000000000001
100000000000000000001
100000000000000000001
100000000000000000001
100000000000000000001
100000000000000000001
100000000000000000001
100000000000000000001
100000000000000000001
100000000000000000001
100000000111111111101
100000000111111111101
110000001111111111101
101000000111111111101
100000000111111111101
100000000111111111101
1000000001111111111011111
1000000001111111111000001
100000000111111111111110111
100000000000000000000000001
100000000111111110111111101
100000000000000000000000001
10010000011111111111111111
1000000001111111111
1111111111111111111
1111111111111111111
