1111111111111
1           1
1 N    11   1
1           1
1      1    1
1      1    1
1           1
1           1
1           1
1           1
1           1
1           1
1           1
1           1
1           1
1111111111111
