R 640 480
NO ./images/NO.xpm
SO ./images/SO.xpm
WE ./images/WE.xpm
EA ./images/EA.xpm
S ./images/ITEM.xpm
F 110,153,15
C 255,255,255

1111111111
1000010001
1000000001
1000000001
10000S0001
1000000001
1000000001
1000010001
1111111111
