R 640 480

NO ./path_to_the_north_texture

SO ./path_to_the_south_texture

WE ./path_to_the_west_texture

S ./path_to_the_sprite_texture

EA ./path_to_the_east_texture

F 220,100,0

C 225,30,0

1111111111111111111111       1111111
1111110000000000000001       1000001
1100011111111111111101       1000001
100N01        111111001      1000001
100001        1000001001     1111111
100011111111111000001001
100000000000000000001101
111111100111111111001101
111111100111000111001101
111111000011000111101101
111100000111111111100001
111100000000000000001111
111111111111111111111111
