C 0 , 191 , 255
R   1000   1000
NO ./images/NO.xpm
EA  ./images/EA.xpm
SO    ./images/SO.xpm
WE ./images/WE.xpm
S  ./images/ITEM.xpm
F 40, 31  ,   19000 4

 11111111111
10000010001
10000N00001
10000000001
11111111111
