R 640 480
NO ./images/NO.xpm
SO ./images/SO.xpm
WE ./images/WE.xpm
EA ./images/EA.xpm
S ./images/ITEM.xpm
F 110,153,15
C 255,255,255

111111111111111111111111
101010101010101001010101
100000000000000000000001
100000000000000000000001
100000000000000000000001
100000000000000000000001
100000000000000000000001
101010101010101001010101
101010101010101001010101
100000000000000000000001
100000000000000000000001
100000000001000000000001
100000000010100000000001
100000000000000000000001
10000000000N000000000001
100000000000000000000001
100000000000000000000001
100000000000000000000001
100000000000000000000001
100000000000000000000001
111111111111111111111111
